8
5
C-------
-H--Y---
--------
--------
--------
