8
5
C--Y----
----Y---
Y-------
------Y-
----H---
